0 --- 1111111111111111111111111111QQQQQ
1 --- 1000000000110000000000001QQQQQQQQ
2 --- 1011000001110000001000001QQQQQQQQ
3 --- 10010000000000000000000011111111Q
4 --- 111111111011000001110000000000001
5 --- 10000000001100000111011111111111Q
6 --- 11110111111111011100000010001QQQQ
7 --- 11110111111111011101010010001QQQQ
8 --- 11000000110101011100000010001QQQQ
9 --- 10001000000000001100000010001QQQQ
10 -- 10000000000000001101010010001QQQQ
11 -- 11000001110101011111011110N0111QQ
12 -- 11110111QQ110101Q101111010001QQQQ
13 -- 11111111Q1111111Q111111111111QQQQ

